  ###################
      #       #     #
# ### # ########### #
# #         # #   # #
# ########### # # # #
# #   # # #     # # #
# ### # # ##### ### #
#     # # #       # #
# ##### # ### ### # #
# #   # #   #   #   #
# ### # # ##### # ###
#   # # #       #   #
# ### # ##### # # ###
#   #         # #   #
### # # # ##### #####
#     # #   # #     #
# # ##### ### ### # #
# #   #   # #     # #
# # # ##### ### # ###
# # #       #   #   
###################