  #######################################
    # # # #   #   #       #   # #       #
### # # # ### ### ### ### # # # ### #####
#   #       #   #       # # #         # #
# # # # ### # ####### ### # # # # ### # #
# #   #   #       #   #     # # # # #   #
### ########### # ### ### ### ### # # # #
# #   #   #     #     # #   # # #   # # #
# ####### ### # # # ### ####### # # ### #
# # #   # #   # # # # #   # # # # #   # #
# # ### # ##### ##### ### # # # ##### # #
#     # #   #       #   #   #       # # #
# # ### # ### ### ### ### # ### # ##### #
# #     #     #           #     # # #   #
# ##### # ##### ### ##### # # ### # #####
#   #         #   #   # # # #   # #     #
# ####### ######### ### ### ### # ### ###
#   # #   # #       #       #   #       #
##### # ### # # ##### ####### ### ### # #
# #     #   # # # #     #       # #   # #
# ### ### ####### ### ### ###############
#   # # #         # # #   #   #   # #   #
# ##### ##### ### # ### # # ### ### ### #
# # # # # # #   # #     #   # #     #   #
# # # # # # ##### ### ### ### # # ##### #
# #     #   # # # #     #     # # #     #
# ### # # # # # # ######### ### ##### # #
# #   #   #           #   # #       #
# # ### # # ##### # ### ### ##### # # ###
# # #   # # #   # #       #   #   #     #
# # ##### # # ### # ##### ### # # # # ###
# # #   # # # # # #   #   #     # # # # #
# ### # # ### # ##### ########### ### # #
#     #     # #     #   #       #   # # #
### ##### # # # ##### # # ### ##### ### #
#       # # #   #   # #     #       #   #
# ####### # # ### ### # ### ####### # ###
# #   #   #     # #   #   #   #   #     #
# ### ######### # # ### ######### ##### #
#   #           #     #                 
#######################################