  #######################################
  #             #   #     #   #       # #
# # # ##### ####### ##### ### ### ##### #
# # # # #     # #   # #       # # # #   #
# ### # ### ### # ### ### ### # # # # # #
#   #   # #     #     #     #         # #
# ### ### # ##### ##### ### # ####### # #
#         # # #   # #   # # #     #   # #
##### ##### # # # # # ### ##### ####### #
#     # #       # #   # #     #       # #
# ##### ### ####### # # # # ### #########
# # # #       #     # # # #     #     # #
### # ### # ####### ### ### ####### # # #
#         # #   #     #       # #   # # #
# ####### ### ##### # # # ##### ##### # #
# # #   #       #   # # #           # # #
# # # ### ########### # ######### # # # #
# #       #         # # #     #   #     #
### ### ####### # # ### # # # # ### #####
#     # #       # #   #   # # # #   # # #
# ### ### ### # # ### # ### # ####### # #
# #       #   # #   # #   # #     #     #
### # # # # ####### # ### ####### ##### #
# # # # # #     # # #   # # #   #       #
# # # # # # # ### # ### ### # ### # #####
#   # # # # # #     #         #   #     #
####### ##### # ####### # ####### # #####
# #       # # #       # #   #     # #   #
# ##### ### # ########### ### ### # ### #
# #         #     #   #         # #   # #
# ### ######### ### ### ### ##### # # # #
#   #   #   #     #   #   #   # # # #   #
# ### # # ##### ##### # # # ### ####### #
# # # #     # # # # # # # #         #   #
# # ### ##### ### # # ### ######### #####
#   # # #       # #   # #   #     #     #
# # # # # # ##### # ### ######### # # ###
# #       #   # #                   #   #
##### # ####### # # ##### # ####### # # #
#     #       #   #   #   #     #   # # 
#######################################